__________________________________________________________________________________________
P________________________________________________________________________________________1
______________________________________________________________________11111111111111_____W
__________________________________________________________________________________________
___________111111111______________________________________________________________________
_____11111111____________________________________________________________________________W
____1111111111_______________________________________________________1111111111____111111_
_______________11111111111111________1111111111111111_______________11111111______________
_____111111111111__________________11111111____________________11111111111111_____________
__________________11111111__111111111__________________11111111111________________________
_______________11111111111111__________11111111111____________________________________111_
__________________________________111111111111111______11111111_______11111111____________
_1111111111111111_______________________________111111111111______________________________
__________111111111111____________________________________________________________________
_____________________111111111111111______________________________________________________
__________________________________________________________________________________________
______________________________________________________________________________________111_
_11111111111_____1111111111111___________________________111111111111111__________1111111_
__________________________________________________________________________________________
__________________________________________________________________________________________
__________________________________________________________________________________________
__________________________________________________________________________________________
XXXXXXXXXXXXXXXXXXXXXXXXXXXXXXXXXXXXXXXXXXXXXXXXXXXXXXXXXXXXXXXXXXXXXXXXXXXXXXXXXXXXXXXXXX
