1111111111111111111111111111111111111111111111111111111111111111111111111111111111111111111111111111111111111111111111111111111111111111111111111111111111111
1___________________________________________________________________________________________________________________________________________________________1
1___________________________________________________________________________________________________________________________________________________________1
1___________________________________________________________________________________________________________________________________________________________1
1___________________________________________________________________________________________________________________________________________________________1
1___________________________________________________________________________________________________________________________________________________________1
1___________________________________________________________________________________________________________________________________________________________1
1___________________________________________________________________________________________________________________________________________________________1
1________________________________________________________________________________________________________________________________________________W__________1
1__P__________________________________________________________________________________________________________111________________________________1__________1
1___________________________________________________________________________________________________________________________________________________________1
1__1_________________________________________________________________111____________________________________________________________________________________1
1___________________11______________________________________________________________________________________________________________________________________1
1___________________________________________________________________________________________________________________________________________________________1
1_______________________________________1111_________________________________________________________11_____________________________________________________1
1___________________________________________________________________________________________________________________________________________________________1
1__________________________________________________________11_______________________________________________________________________________________________1
1__________________________________________________________________________________________________________________________________11111____________________1
1___________________________________________________________________________________________________________________________________________________________1
1___________________________________________________________________________________________________________________________________________________________1
1________________________________________________________________________________________11_________________________________________________________________1
1___________________________________________________________________________________________________________________________________________________________1
1___________________________________________________________________________________________________________________________________________________________1
1___________________________________________________________________________________________________________________________________________________________1
1___________________________________________________________________________________________________________________________________________________________1
1___________________________________________________________________________________________________________________________________________________________1
1___________________________________________________________________________________________________________________________________________________________1
1___________________________________________________________________________________________________________________________________________________________1
1XXXXXXXXXXXXXXXXXXXXXXXXXXXXXXXXXXXXXXXXXXXXXXXXXXXXXXXXXXXXXXXXXXXXXXXXXXXXXXXXXXXXXXXXXXXXXXXXXXXXXXXXXXXXXXXXXXXXXXXXXXXXXXXXXXXXXXXXXXXXXXXXXXXXXXXXXXX1
