__________________________________________________________________________________________
P________________________________________________________________________________________1
__________________________________________________________________________________________
______________________________________________111111111111111_____________________________
__________________________________________________________________________________________
__________________________________________________________________________________________
_____________________________________11111111111111__________________________111111111111_
___________________________________________11111111111111_________________________________
_____________________________________________________________111111111____________________
__________________________________________________________________________________________
________________________________________________________________________________111111111_
__1111111111111111________________________________________________________________________
______________________________________________11111111111_________________________________
_______________________________________________________________________11111111___________
________________________________________________________________________________111111111_
__________________________________________________________________________________________
__________________________________________________________11111111111111__________________
__________________11111111___________________________________________________111111111111_
__________________________________________________________________________________________
__________________________________________________________________________________________
__________________________________________________________________________________________
__________________________________________________________________________________________
XXXXXXXXXXXXXXXXXXXXXXXXXXXXXXXXXXXXXXXXXXXXXXXXXXXXXXXXXXXXXXXXXXXXXXXXXXXXXXXXXXXXXXXXXX
