__________________________________________________________________________________________
P________________________________________________________________________________________1
________________________________________________________1111111111111111111111111111______
____________________________________111111111111111_______________________________________
__________________________________1111111111111111____________________________11111111111_
_____________________________________________________________________111111111111111______
_______________________________________________________________________11111111111111_____
____________________________11111111111111__________________________1111111111111111______
__________111111111111__________1111111111111________1111111111_____________________11111_
_________________________________________111111111111_1111111111__________________________
___11111111111111__________11111111__________________________111111111111_________________
______111111111111111________________________________________________________________1111_
______________11111111111111______________________________________________________________
_11111111_________________________________________1111111111______________________________
___________11111111__________________________111111111111_________________________________
__________________________________________________________________________________________
__________________________________________________________________________________________
_____________________________________________________________________11111111111111____11_
__________________________________________________________________________________________
__________________________________________________________________________________________
__________________________________________________________________________________________
XXXXXXXXXXXXXXXXXXXXXXXXXXXXXXXXXXXXXXXXXXXXXXXXXXXXXXXXXXXXXXXXXXXXXXXXXXXXXXXXXXXXXXXXXX
