__________________________________________________________________________________________
P________________________________________________________________________________________1
________________________1111111111111111__________________________________________________
____________11111111111111________________________________________________________________
__________________________________________________________________________________________
_____________________________________________111111111111111______________________________
__________________11111111111111__________________________________________________1111111_
____________________________________________________________________________________11111_
____________________111111111111__________________________________111111111_______________
_________________11111111111__________________________11111111111111______________________
_________________11111111111_____________________________111111111111___111111111_________
__________________________________________________________________________________________
_____________________________1111111111___________________________________________________
__1111111111______1111111111______________________________________________________1111111_
________________________________111111111111111___________________________________________
_______________________________1111111111111______________________________________________
__________________________________1111111111111111________________________________________
______________________111111111111________________________________________________________
__________________________________________________________________________________________
__________________________________________________________________________________________
__________________________________________________________________________________________
__________________________________________________________________________________________
XXXXXXXXXXXXXXXXXXXXXXXXXXXXXXXXXXXXXXXXXXXXXXXXXXXXXXXXXXXXXXXXXXXXXXXXXXXXXXXXXXXXXXXXXX
