1111111111111111111111111111111111111111111111111111111111111111111111111111111111111111111111111111111111111111111111111111111111111111111111111111111111111
1___________________________________________________________________________________________________________________________________________________________1
1___________________________________________________________________________________________________________________________________________________________1
1___________________________________________________________________________________________________________________________________________________________1
1___________________________________________________________________________________________________________________________________________________________1
1___________________________________________________________________________________________________________________________________________________________1
1___________________________________________________________________________________________________________________________________________________________1
1___________________________________________________________________________________________________________________________________________________________1
1________________________________________________________________________________________________________________________________________________W__________1
1__P__________________________________________________________________________________________________________111________________________________1__________1
1___________________________________________________________________________________________________________________________________________________________1
1__1_________________________________________________________________111____________________________________________________________________________________1
1___________________11______________________________________________________________________________________________________________________________________1
1___________________________________________________________________________________________________________________________________________________________1
1_________________________________________11_________________________________________________________1______________________________________________________1
1___________________________________________________________________________________________________________________________________________________________1
1___________________________________________________________1_______________________________________________________________________________________________1
1__________________________________________________________________________________________________________________________________________11_______________1
1___________________________________________________________________________________________________________________________________________________________1
1___________________________________________________________________________________________________________________________________________________________1
1________________________________________________________________________________________11_________________________________________________________________1
1___________________________________________________________________________________________________________________________________________________________1
1___________________________________________________________________________________________________________________________________________________________1
1___________________________________________________________________________________________________________________________________________________________1
1___________________________________________________________________________________________________________________________________________________________1
1___________________________________________________________________________________________________________________________________________________________1
1___________________________________________________________________________________________________________________________________________________________1
1___________________________________________________________________________________________________________________________________________________________1
1XXXXXXXXXXXXXXXXXXXXXXXXXXXXXXXXXXXXXXXXXXXXXXXXXXXXXXXXXXXXXXXXXXXXXXXXXXXXXXXXXXXXXXXXXXXXXXXXXXXXXXXXXXXXXXXXXXXXXXXXXXXXXXXXXXXXXXXXXXXXXXXXXXXXXXXXXXX1
