__________________________________________________________________________________________
P________________________________________________________________________________________1
________________________________________11111111111111_________________111111111__________
______________________________________________________________11111111111111______________
_______________________________________________________________________1111111111111111___
____________________________________________________________________________1111111111111_
__________________________________________________________________________________________
_____________________________________________________________1111111111111111_____________
_________________________________________111111111111____________1111111111111______11111_
______________________________111111111______________________________________________1111_
___________________________________________________111111111111111__11111111111111________
__________________________________________________________________________________________
______________111111111111____11111111111111______________________________________________
__________________________________________________________________________________________
________________________111111111111_____________________________________________11111111_
__________________________11111111111_____________________________________________________
____________1111111111111_________________________________________________________________
____1111111111111111______________________________________________________________________
__________________________________________________________________________________________
__________________________________________________________________________________________
__________________________________________________________________________________________
__________________________________________________________________________________________
XXXXXXXXXXXXXXXXXXXXXXXXXXXXXXXXXXXXXXXXXXXXXXXXXXXXXXXXXXXXXXXXXXXXXXXXXXXXXXXXXXXXXXXXXX
