__________________________________________________________________________________________
P________________________________________________________________________________________1
_______11111111111111______________________11111111____________________1111111111111______
_____________________________________________________1111111111111______111111111111111___
_______1111111111____11111111111111_____________________11111111111____________1111111111_
_____________________________1111111111111111________________________________________1111_
_____________________________________111111111____________________________________________
___________________________________________________________________1111111111111111_______
_______1111111111________________11111111___________________________11111111111_______111_
__________________________________________________________________________________________
__________________________________________________________________________________________
_______________________________________________________________________________1111111111_
________________11111111111111____________________________111111111111111_________________
____________________________________1111111111111111______________________________________
________________________________1111111111________________________________________________
__________________________________________1111111111111111________________________________
_______________________11111111111________________________________________________________
__________________________________________________________________________________________
__________________________________________________________________________________________
__________________________________________________________________________________________
__________________________________________________________________________________________
__________________________________________________________________________________________
XXXXXXXXXXXXXXXXXXXXXXXXXXXXXXXXXXXXXXXXXXXXXXXXXXXXXXXXXXXXXXXXXXXXXXXXXXXXXXXXXXXXXXXXXX
