__________________________________________________________________________________________
P________________________________________________________________________________________1
_______________________1111111111111______________________________________________________
_______111111111___________________________________1111111111_____________________________
_____________________________________11111111111______________111111111_____1111111111111_
__________________________________________________________________________________________
_______________11111111___________________11111111__________1111111111111111______1111111_
________________________1111111111________________________________________________________
_______________________________________________________1111111111_________11111111111_____
________1111111111________________________________________________________________________
______________1111111111111_____________________________________________________________1_
__________________________________________________________________________________________
_______________________111111111111_____________________11111111111_______________________
_________________________________________________________________11111111111______________
__________________________________________________________________________________________
__________________________________________________________________________________________
_________________11111111111______________________________________________________________
__________________________________________________________111111111111111_________________
__________________________________________________________________________________________
__________________________________________________________________________________________
__________________________________________________________________________________________
__________________________________________________________________________________________
XXXXXXXXXXXXXXXXXXXXXXXXXXXXXXXXXXXXXXXXXXXXXXXXXXXXXXXXXXXXXXXXXXXXXXXXXXXXXXXXXXXXXXXXXX
