__________________________________________________________________________________________
P________________________________________________________________________________________1
__________________________________________________________________________________________
__________111111111111______________________1111111111___________111111111111111111111111_
_______1111111111111111____________________________________________________________111111_
_______________111111111_______________________________111111111111111____________________
____________________________________11111111111111________________________________________
________11111111111_______________________________________________________________________
_________________________________1111111111111111__________________1111111111_____________
______________________________111111111111111_____________________________________________
__________________________________________________________________________________________
__1111111111111111___________________________________________________111111111111_________
________________________111111111______________________________________11111111111________
__________________________________________________1111111111111111__________111111111_____
_______111111111111__________________________________________________________11111111111__
___________________________________________________1111111111___________111111111111111___
________________________________________1111111111111111111111____________________________
__________________________________________________________________________________________
__________________________________________________________________________________________
__________________________________________________________________________________________
__________________________________________________________________________________________
__________________________________________________________________________________________
XXXXXXXXXXXXXXXXXXXXXXXXXXXXXXXXXXXXXXXXXXXXXXXXXXXXXXXXXXXXXXXXXXXXXXXXXXXXXXXXXXXXXXXXXX
