__________________________________________________________________________________________
P________________________________________________________________________________________1
______________________________________________________________________________11111111111_
______________________________________________________1111111111111111________11111111111_
________11111111111111_111111111111111____________________________________________________
___________11111111______________________11111111111111__________________________________W
_____________________________________________________________________11111111_____________
________1111111111111___________________________________________________________111111111_
______11111111111__________________________________________11111111111________________111_
__________________________________________111111111111111_________________________________
__________________________________________________________________________________________
___________________________________________________________________________________111111_
_111111111111________________11111111111111_______________________________________________
__________________11111111111111_______________111111111__________________________________
_______________________11111111111111_______11111111___________11111111111111_____________
_____________________________________________111111111111____111111111____________________
___________________________________________________________________11111111_______________
_____________________________________11111111111111_____11111111111____________1111111111_
__________________________________________________________________________________________
__________________________________________________________________________________________
__________________________________________________________________________________________
__________________________________________________________________________________________
XXXXXXXXXXXXXXXXXXXXXXXXXXXXXXXXXXXXXXXXXXXXXXXXXXXXXXXXXXXXXXXXXXXXXXXXXXXXXXXXXXXXXXXXXX
