__________________________________________________________________________________________
P________________________________________________________________________________________1
_________11111111___111111111111__________________________________________________________
___________1111111111_____________________________________________________________________
__111111111111____________________1111111111111111___111111111111111111111111_____________
__________________________________111111111____________________111111111111______11111111_
____________________________________________________________________________________11111W
________________________________________1111111111111111___________________________111111_
__________________________________________________________________________________________
__________________________________________________________________________________________
_________________________________________________111111111______________1111111111111_111_
________________________________________111111111____________________1111111111111111_____
_____________________________________________111111111111111_____1111111111111111_________
__________________________________________________________________________________________
_________111111111111111________________________________11111111_1111111111111111_________
___111111111_________________________________________________111111111____________________
______________________________________________________________111111111___________________
__________________________________________________________11111111111111__________________
__________________________________________________________________________________________
__________________________________________________________________________________________
__________________________________________________________________________________________
__________________________________________________________________________________________
XXXXXXXXXXXXXXXXXXXXXXXXXXXXXXXXXXXXXXXXXXXXXXXXXXXXXXXXXXXXXXXXXXXXXXXXXXXXXXXXXXXXXXXXXX
