__________________________________________________________________________________________
P________________________________________________________________________________________1
__________________________________________________________________________________________
_______________________________1111111111111111_11111111111111__________________111111111_
___________________________111111111111111________________________________________________
___________111111111111___________________________________________11111111________________
_________________________1111111111_______________________________________________________
____________111111111______________________________11111111_______________________________
________________________________________________________________11111111111_______________
________________________________________11111111111_________________________111111111111__
__________________________________________________________________________________________
___________________111111111111___________________________________________________________
______________________________11111111111______1111111111111______________________1111111_
__________________________________________________________________________________________
_____________11111111111________________________11111111111_______________________________
__________________________________________________________________________________________
__________________________________________________________________________________________
_____111111111111111_______11111111111____________________________________________________
__________________________________________________________________________________________
__________________________________________________________________________________________
__________________________________________________________________________________________
__________________________________________________________________________________________
XXXXXXXXXXXXXXXXXXXXXXXXXXXXXXXXXXXXXXXXXXXXXXXXXXXXXXXXXXXXXXXXXXXXXXXXXXXXXXXXXXXXXXXXXX
