__________________________________________________________________________________________
P________________________________________________________________________________________1
______________________________________11111111111111_____111111111111111_____111111111111_
_________________________________________________________11111111_________________________
___________________________________11111111111______________________________________11111_
__________111111111111111_________________________________________________________________
_____________________111111111____________________________________________________________
___________________111111111111___________________________________________________________
__________________________________________________________________111111111_______________
__________________________1111111111111___________________111111111________1111111111111__
_________________________1111111111111_______________________11111111111111______________W
________________________________________________________________________1111111111111_____
_______________________________________________________111111111111111____________________
____________________________________________________________________111111111111111111111_
__________________________________________________________________________________________
____________________________1111111111____________________________________________________
__________________________________________________________________________________________
__________________________________111111111111_______1111111111111111_____________________
__________________________________________________________________________________________
__________________________________________________________________________________________
__________________________________________________________________________________________
__________________________________________________________________________________________
XXXXXXXXXXXXXXXXXXXXXXXXXXXXXXXXXXXXXXXXXXXXXXXXXXXXXXXXXXXXXXXXXXXXXXXXXXXXXXXXXXXXXXXXXX
