__________________________________________________________________________________________
P________________________________________________________________________________________1
__111111111111111_____11111111111111______________________________________________________
_____1111111111__________111111111___________________________________________11111111111__
______________________________________________1111111111__________________________________
_________________________________________________________________________111111111111____W
___________________________________________________________________________________111111_
_______________________________________________1111111111111111___________________________
_______________________________________111111111111_________________________________11111W
_______________________111111111111111_______1111111111111111111___________111111111111___
__________________________________________________________________________________________
________________________________1111111111_________________________________________111111_
__________________________________________________________________111111111_______________
____________1111111111___________________________________________________________________W
__________________111111111111________________________________1111111111111_______________
__________________________________________________________________________________________
__11111111__________11111111_________________________________11111111111_____________1111_
__________________________________________________________________________11111111111_____
__________________________________________________________________________________________
__________________________________________________________________________________________
__________________________________________________________________________________________
__________________________________________________________________________________________
XXXXXXXXXXXXXXXXXXXXXXXXXXXXXXXXXXXXXXXXXXXXXXXXXXXXXXXXXXXXXXXXXXXXXXXXXXXXXXXXXXXXXXXXXX
