__________________________________________________________________________________________
P________________________________________________________________________________________1
__________________________________________________________________________________________
_________________________________________________________________111111111111111__________
______________________________11111111111111______________1111111111111______11111111111__
__________________________1111111111111111___1111111111__________________________________W
_______________________________________________________1111111111111______________________
__________________________________________11111111________________________________________
__________________________________________________________________111111111111____________
__________________________________________________________________________________________
_____________________________________________________________________________________1111_
_________________________________________________________________________________________W
__________________________________________________________________________________________
_________11111111111111________________________________________11111111111111_____________
________111111111111111__________________________________________________________________W
_________________________111111111111_____________________________________________________
_____________________________________________________________________________________1111W
_________________________________________________________1111111111111________________111_
__________________________________________________________________________________________
__________________________________________________________________________________________
__________________________________________________________________________________________
__________________________________________________________________________________________
XXXXXXXXXXXXXXXXXXXXXXXXXXXXXXXXXXXXXXXXXXXXXXXXXXXXXXXXXXXXXXXXXXXXXXXXXXXXXXXXXXXXXXXXXX
