1111111111111111111111111111111111111111111111111111111111111111111111111111111111111111
1______________________________________________________________________________________1
1______________________________________________________________________________________1
1___1111111________________________________________________________________111111______1
1_____________________1111111111111111_____________11111111111_________________________1
1______________________________________________________________________________________1
1______________________________________________________________________________________1
1_111111111111__________________________________________________________________________
1____________________________11111111___________________________________________________
1_________________________________________________________________________111111111_____
1_____________________________________________________________1111______________________
1_____________________111111111111______________________________________________________
1____________11111__________________________111111111__________11111____________________
1_______________________________________________________________________________________
1111111111____________________111111____________________________________________________
1________P______________________________________________________________________________
1____________________________________________________________111____________111111111111
11111111111111111____________________________1111111____________________________________

