________________________________________________________________________________
P______________________________________________________________________________1
____11111111111_____________________1111111111__________________________________
________________________________________________________________________________
__________________________________________________________1111111111111111______
__________11111111111111________________________________________________________
_______________________________________________________1111111111111____________
________________111111111111111_______1111111111111111__________________________
_____________________________11111111111111___________11111111111_______________
________________________________________________________________________________
________________________________________11111111111_____________________________
__________1111111111111111111111___________________1111111111111111_____________
______________________________111111111111111___________________________________
________________________________________________________________________________
________________________________________________________________________________
________________________________________________________________________________
________________________________________________________________________________
__________________________________________________________________11111111______
________________________________________________________________________________
________________________________________________________________________________
________________________________________________________________________________
XXXXXXXXXXXXXXXXXXXXXXXXXXXXXXXXXXXXXXXXXXXXXXXXXXXXXXXXXXXXXXXXXXXXXXXXXXXXXXXX
