________________________________________________________________________________
P______________________________________________________________________________1
________________________________________________________________________________
____111111111111_____________________111111111_________________111111111111111__
_11111111111111111111111111111111111111_______________________________________1_
__________111111111____111111111_____1111111111111111_______________________111_
_____________________________________________________________________________11_
________________________________________________________________________________
________________________________________________________________________________
________________________________11111111__________________1111111111111_1111111_
________________________________________________________________________________
_________________________________________11111111111111_________________________
________________________________111111111111____________________________________
_______________________________1111111111_______________________________________
________________________________________________________________________________
___________________1111111111111111_____________________________111111111111____
_____1111111111111______________________________________________________________
________1111111111____________________1111111111________________________________
XXXXXXXXXXXXXXXXXXXXXXXXXXXXXXXXXXXXXXXXXXXXXXXXXXXXXXXXXXXXXXXXXXXXXXXXXXXXXXXX
________________________________________________________________________________
