________________________________________________________________________________
P______________________________________________________________________________1
________________________________________________________________________________
________________________________________________________________________________
___________1111111111111111_____________________________________________________
_________1111111111111111___11111111111_________________________________________
_____________111111111__________________________11111111111_____________________
_______________________________11111111___11111111111111_____________1111111111_
________________________________________________________________________________
____________________1111111111_____________________________1111111111111111_____
________________________________________________111111111_______________________
______111111111_____________________________1111111111111____________________11_
__________________________________________________________________________11111_
____________1111111111111111_111111111111_______________________________________
____________111111111111111_________________________________________11111111111_
________________11111111________________________________________________________
________________________________________________________________________________
________________________________________________________________________________
XXXXXXXXXXXXXXXXXXXXXXXXXXXXXXXXXXXXXXXXXXXXXXXXXXXXXXXXXXXXXXXXXXXXXXXXXXXXXXXX
________________________________________________________________________________
