_______________________________________________________________________
1_____________________________________________________________________1
1__________________________________________________11111111111________1
1_______111111111__________________111________________________________1
1_____________________________________________________________________1
1_____________________11______________________________________________1
1_____________________________________________________________________1
1__________________11111111_________________________111_______________1
1___P_________________________________________________________________1
1___________________________________11111111__________________________1
11111111111______________________________________________11111111111111
1_____________________________________________________________________1
1______________________________________________11_____________________1
1___________1111111111________________________________________________1
1_____________________________________________________________________1
1_________________________________11111111111__________________11_____1
1_____________________________________________________________________1
1________________________________________________________11___________1
1_____________________________________________________________________1
XXXXXXXXXXXXXXXXXXXXXXXXXXXXXXXXXXXXXXXXXXXXXXXXXXXXXXXXXXXXXXXXXXXXXXX
