__________________________________________________________________________________________
P________________________________________________________________________________________1
_____________________________________________________11111111111__________________________
__________________________________________________________11111111111_____________________
___________________________________________________________________________111111111______
______11111111111111_________________________________11111111111_____111111111111_______1_
_________________________________11111111_________________________________________________
_________________________________________1111111111_______________________________________
_1111111111________________1111111111111111________1111111111111111_______________________
_____________________________________________________________________111111111111111______
_________111111111111______________________________111111111111_______________________111_
________________________1111111111______11111111__________________________________________
_____111111111111_________________________________________________________________________
_____________________________________11111111_____________________________________________
_____________________________________________________________________11111111_____________
__11111111111__11111111111111_____________________________________________________________
________________________111111111111_1111111111___1111111111111____________1111111111_____
___111111111111111________________________________________________________________________
XXXXXXXXXXXXXXXXXXXXXXXXXXXXXXXXXXXXXXXXXXXXXXXXXXXXXXXXXXXXXXXXXXXXXXXXXXXXXXXXXXXXXXXXXX
__________________________________________________________________________________________
