P1_11_1_1111111_111_____11111____111_1_11___1_11__111_111_1__11_1____1_1__1__1__
1___1_1_1____1__1_111__1____1_11_11_111_1__1___1__1__11_1__1111_1_1___11__1_1111
_____11111111__111___1_1__1_1_1_1_11_1_1_111_1_1__1___1_111111_1_111__1_1111_1_1
111____11_111111_11_11_1___1_1_111_111_111_11__111_1_11111_1__1_1_111_1_11__11_1
1111_1__11__111__111_1_1__1_111_111____1__11__1_11_111__1_1_1___11111_1_111_111_
__1111_11_111_____11_1_1__111_111111__1___1111111_1111111__11111__1_1_1____11_1_
11_111_11_1_111111111_1_111111__1_1_1111_111111__1_11111_11111_11_11111111111111
_111111111_111111_11_1111111111__11_1111_1111____11_____11111__1111_1111__1_111_
_1111_1111__1_______1__111111_1__1___11_11_111111_111_1__111111_1____1111___1111
1_11___1_11_1___1__11_1111___1_1_11___1111_1___1__1___1111__11111_1_1__11111____
____11111_1111_1_11_111_111_1_11_111___11_111_1___1_11___1_1111_111___11__1_1__1
111_11_1__11_1111_11_1_1_1__11111___11111_11___11____11__11_1_11111_111_1111_1_1
____11___1_111_1__11__111111__1111_11111_11111__111_1___1__1_1111_11_11_11_11_11
_11_11___1111___111_1111111_1___111___11_1__1___11_11_111___11111__1_11__1111111
______11_11_____11__1_111_11_1_11__1____111111_11111_11_1_11__111_1_1__1___11111
_11111__111_111111111_1_1_1_11111_11_11111_1_111_11_1111__111111111_1__1____1_11
111__1111_11__11_11___11___111____1__1111____1111111___11_11_11__1_1____11__11_1
__1111_11_11____1_111_11_11_1_1_1________11111111_1_111_1_11_1_11_1__1_____11___
111_1111___11__111111111__111_11_1____11111111_11111_11_1111111__1___111____111_
11_11111__11111_1__11_1111___111111____1__1111___1_1____111__111_11_11_111_1_1_1
