1111111111111111111111111111111111111111111111111111111111111111111111111111111111111111
1______________________________________________________________________________________1
1______________________________________________________________________________________1
1___1111111________________________________________________________________111111______1
1__________________________________________________11111111111_________________________1
1______________________________________________________________________________________1
1______________________________________________________________________________________1
1______________________________________________________________________________________1
1____________________________11111111__________________________________________________1
1_________________________________________________________________________111111111____1
1_____________________________________________________________1111_____________________1
1______________________________________________________________________________________1
1____________11111__________________________111111111__________11111___________________1
1______________________________________________________________________________________1
1111111111____________________111111___________________________________________________1
1______________________________________________________________________________________1
1____________________________________________________________111_______________________1
1__________111111111_________________________1111111___________________________________1
1______________________________________________________________________________________1
1__________________________1111111111111_______________________________________________1
1___________________________________________________________________1___111___1________1
1______________________________________________________________________________________1
1________________111111111111__________________________________________________________1
1______________________________________________________________________________________1
1___11111____________________________________________1111_____________1111111__________1
1______________________________________________________________________________________1
1_________________________________1111_________________________________________________1
1_________111_________________________1111111__________________________________________1
1_________________________11___________________________________________________________1
1______________________________________________________________________________________1
1_______________________________________________________________1111111111111111_______1
1______________________________________________________________________________________1
1___________________________111111_____________________________________________________1
1__________________________________________________11111111111_________________________1
1_______111111111__________________111_________________________________________________1
1______________________________________________________________________________________1
1______________________________________________________________________________________1
1______________________________________________________________________11111111111_____1
1__________________11111111_________________________111________________________________1
1________P_____________________________________________________________________________1
1___________________________________11111111___________________________________________1
11111111111______________________________________________11111111111111111_____________1
1______________________________________________________________________________________1
1______________________________________________________________________________________1
1______________________________________________________________________________________1
XXXXXXXXXXXXXXXXXXXXXXXXXXXXXXXXXXXXXXXXXXXXXXXXXXXXXXXXXXXXXXXXXXXXXXXXXXXXXXXXXXXXXXXX
