________________________________________________________________________________
P______________________________________________________________________________1
______________________________________________________________11111111111111____
__________________________111111111111111_______________________________________
________________________________________________________________________________
___1111111111_____________________________________________________11111111111___
__________________________1111111111____________________________________________
_____111111111111111_____________________111111111111___________________________
____________________1111111111111111__________________________111111111111______
______________________1111111111________________________________________________
________________________________________________________________________________
________________________________________________________________________________
____________________________________________________________________11111111111_
____________________11111111111111111111111_________11111111111111111111111111__
________________________________________________________________________________
____111111111111___________________________________________________1111111111___
______111111111111111____111111111111111_____1111111111111______________________
__________________________________________________________________________11111_
XXXXXXXXXXXXXXXXXXXXXXXXXXXXXXXXXXXXXXXXXXXXXXXXXXXXXXXXXXXXXXXXXXXXXXXXXXXXXXXX
________________________________________________________________________________
