XXXXXXXXXXXXXXXXXXXXXXXXXXXXXXXXXXXXXXXXXXXXXXXXXXXXXXXXXXXXXXXXXXXXXXXXXXXXXXX
X_____________________________________________________________________________X
1_____________________________________________________________________________1
1_____________________________________________________________________________1
1_____________________________________________________________________________1
1_____________________________________________________________________________1
1_____________________________________________________________________________1
1_____________________________________________________________________________1
1_____________________________________________________________________________1
1_____________________________________________________________________________1
1_____________________________________________________________________________1
1_____________________________________________________________________________1
1_____________________________________________________________________________1
1_____________________________________________________________________________1
1__________________________________________________11111111111________________1
1_______111111111__________________111________________________________________1
1_____________________________________________________________________________1
1_____________________11______________________________________________________1
1_____________________________________________________________________________1
1__________________11111111_________________________________111_______________1
1_____________________________________________________________________________1
1___________________________________________11111111__________________________1
11111111111______________________________________________________11111111111111
1_____________________________________________________________________________1
1______________________________________________11_____________________________1
1___________1111111111________________________________________________________1
1_____________________________________________________________________________1
1_________________________________11111111111__________________________11_____1
1_____________________________________________________________________________1
1_____P__________________________________________________11_________________W_1
1_____________________________________________________________________________1
11111111111______________________________________________________11111111111111
1_____________________________________________________________________________1
1_____________________________________________________________________________1
1______111111___1___1___1_11111_______1___1___1___1____111__1111__111__1111___1
1______1_______1_1__11_11_1___________1__1_1__11_11___1___1_1__1_1___1____1___1
1______1__111_11111_1_1_1_111_____1___1_11111_1_1_1______1__1__1____1__111____1
1______1____1_1___1_1___1_1_______1___1_1___1 1___1_____1___1__1___1______1___1
1______111111_1___1_1___1_11111___11111_1___1_1___1____1111_1111__1111_1111___1
1_____________________________________________________________________________1
1_____________________________________________________________________________1
1_____________________________________________________________________________1
1_____________________________________________________________________________1
1XXXXXXXXXXXXXXXXXXXXXXXXXXXXXXXXXXXXXXXXXXXXXXXXXXXXXXXXXXXXXXXXXXXXX1XXXXXXXX
