P__1111___111__11__111_1_11_111_1111_11_111111___111_1_111_1_11111111__1_111___1
__1_11111__11_111_11____11_1___1111__1_111_1_11_1_1_111_11_111_1111111__11__11_1
____11_11__111__1_11__1_1__11_1_1_1____1__11_1_1__1_1_11_1______111_11_111__111_
_111____1_1_11111_1_1_11_111___1__11111___11_1__11_11____1_111____1__111111__1__
_11__1111_11_1_111_11___1111___111___1_11__11111_11_11_1_11111__1__111111111___1
_11__1__111_11_1__111___111111111__11__1_1_______1111_11_11_11___1_11__11_1_1_11
1_11111__111_11_11__11111_11___111_1__11___111111111111___111_1111_111_1_11_111_
_1_1__111__11_111__1_______1_1__1111_1__1111_111_1_11_1111_111___11111_1_111_1__
__111_1__111_1111__1__1_1___11_1_1_11111_1__111__111111_____11_11_11_11_111_111_
_____11_1____1_1_1_1111___1_111_111_1111___11111_1111111__111111_1__1__1_1111_11
_11_1_111111_1111_1_11___11_111_1_11_1111_111_11___1_1111__111111__1__111___111_
__1_1_111____1111111__1_11_11111111111____1___1111111_11111_111_1__111_11_111_11
___1111_111__1___111_1_111111_1111_111____1__11_11_11_1_11_1_____11111_1__1_1_1_
1_1_____1_1___11111___1111111_1_1___1__111111_1__1111_11111_111111111_11___111_1
11__111111_1111111__1_1_111_1_111_1_111_11_111111__1_1_1_1__111_1111__11111_1__1
111_111_1_1_1_1___111_1__1_____1_11_111_1_111_1_11_11_11111_1___11111_111111_1_1
_1111111111_1_11111___111111111______11_1_111_111_11__1_11_1_11111_11_11111__1__
11__111_11_11_111_11__111_1_111__1_111_11_11_1__111111111111111_11_1111111_11111
111111____11__11_1111111111_1_11___111___1_111_1_11111_1111_1111111111111_11_11_
11111_111_11_1__11_11_11111111111111__1_1__1_11___11__111___1111_1__11_1_11_1111
