__________________________________________________________________________________________
P________________________________________________________________________________________1
_______________________________________________________11111111111111_____________________
_____________11111111_____________________________________111111111111____________________
__________________________________________________________________________________________
______________________________________________111111111111111_____________________________
____________________________1111111111_11111111111111________________________111111111111_
_________111111111111_________________________________11111111111111______________________
__________________1111111111______________________________________________________________
_____________________________________1111111111111________________________________________
______________________________11111111111111______________________________________1111111_
_______________________111111111111_______________________________________________________
___________________________________11111111111111__111111111111111________________________
________________________1111111111111111________________________111111111_________________
__________________________________________________________________________________________
____________________________11111111111111________________________________________________
__11111111____________________________________11111111111111______________________________
_________________________________________________________111111111111___________111111111_
XXXXXXXXXXXXXXXXXXXXXXXXXXXXXXXXXXXXXXXXXXXXXXXXXXXXXXXXXXXXXXXXXXXXXXXXXXXXXXXXXXXXXXXXXX
__________________________________________________________________________________________
