__________________________________________________________________________________________
P________________________________________________________________________________________1
_111111111_________11111111111____________________________________________________________
_____________________1111111111111111_____________11111111______________1111111111______1_
_________________________________________________111111111111111__11111111111111111_______
_1111111111_______________________________________________________________________________
_______11111111111111___________________________________________1111111111________________
____________________________________________________________________1111111111111_________
_________________________________11111111111111___________________________________________
______________________11111111111_________________________________________________________
___________________________________11111111________________________________________111111_
_________________________________________________________________________11111111111111___
____________________________11111111_______________1111111111111111_______________________
___________________11111111111111______________________________________111111111111111____
_____1111111111___________________________________________________________________________
_____________________11111111111111________________11111111_______________________________
___________________________________________________________________111111111__________111_
______________1111111111____1111111111____________________________________________________
__________________________________________________________________________________________
__________________________________________________________________________________________
__________________________________________________________________________________________
XXXXXXXXXXXXXXXXXXXXXXXXXXXXXXXXXXXXXXXXXXXXXXXXXXXXXXXXXXXXXXXXXXXXXXXXXXXXXXXXXXXXXXXXXX
