__________________________________________________________________________________________
P________________________________________________________________________________________1
_________________________________________111111111111111__________________________________
__________________________________________________________________________________________
__________________________________________________________________11111111111111__________
__________________________________________________________________________________________
_______________________1111111111111__________11111111111_11111111________________________
________________________________________________________________1111111111111_____________
____111111111_________________________________________________________1111111111__________
____________________11111111111_________11111111111111____________________________________
_____________________________________________________________11111111111_____1111111111___
_____________________1111111111111________________________________________________________
__________________________________1111111111111________________________111111111__________
____________11111111111_____________________11111111111___________________________________
_____________________________________________________________111111111____________________
____________________________________________________________________________________11111_
__________________________________________________________________________________________
__________________________________________________________________________________________
__________________________________________________________________________________________
__________________________________________________________________________________________
