__________________________________________________________________________________________
P________________________________________________________________________________________1
_____________________________1111111111____________________________________1111111111_____
____________________________11111111111___11111111111111_____1111111111111111_____________
__________________________________________________________________________________________
___________________11111111111111___________________________________________________11111_
______________11111111___________________11111111_________________________________________
____________1111111111___________________________111111111________________________________
_11111111____________________________________________________________________111111111111_
________________________________________________________111111111111_____111111111111111__
_________________________111111111111__________________________________________________11_
_______________________________________________1111111111111111_111111111111111___________
__________________________________________________________________________________________
________________11111111111__________________________________1111111111111111_____________
_____________________111111111_________________________111111111__________________________
_111111111111111______________________________11111111111____11111111______11111111_______
____111111111_________1111111111111111____________________________________________________
__________________________________________________________________________________________
XXXXXXXXXXXXXXXXXXXXXXXXXXXXXXXXXXXXXXXXXXXXXXXXXXXXXXXXXXXXXXXXXXXXXXXXXXXXXXXXXXXXXXXXXX
__________________________________________________________________________________________
