__________________________________________________________________________________________
P________________________________________________________________________________________1
__________________________________________________________________________________________
__________________________________11111111111___________________1111111111111111111111____
____________________________11111111111111________________________________________________
_____________________________11111111111111_______________________________________________
______________________________________1111111111111111____________________________________
__________________________________________________________________________________________
_________________________________________________________1111111111111____________________
__________________________________11111111111111__111111111111111_________________________
____________1111111111111________________________________________________________11111111_
________________________________________________________________________1111111111111_____
_______________________________________________________________________111111111111_______
__________________________________________________________________________________________
__________________________________________________________111111111111111_________________
__________________________________________________________________________________________
_______________________________1111111111111______11111111___________________111111111____
_111111111________________________________________________________________________________
__________________________________________________________________________________________
__________________________________________________________________________________________
__________________________________________________________________________________________
XXXXXXXXXXXXXXXXXXXXXXXXXXXXXXXXXXXXXXXXXXXXXXXXXXXXXXXXXXXXXXXXXXXXXXXXXXXXXXXXXXXXXXXXXX
