__________________________________________________________________________________________
P________________________________________________________________________________________1
_____________________________________________________111111111111_________________________
_____________________________________11111111111__________________________________________
______________________________________________________________11111111111_________________
_________1111111111111111__________________11111111_______________________________________
__________1111111111111___________________________________________________________________
______________________11111111111111______________________________________________________
__________________________________________________________________________________________
______________111111111____________________________________111111111111111________________
_________11111111111111____________________________________________1111111111111111_______
__________________________________________________________________________________________
__________________11111111111111__________________________________________________________
____111111111111_________________________________________________1111111111_______________
______111111111111111___________11111111111111____________________________________________
_____11111111_____________________________________________________________________________
__________________________________________________________________________________________
____________________________________________________________________________111111111111__
__________________________________________________________________________________________
__________________________________________________________________________________________
__________________________________________________________________________________________
XXXXXXXXXXXXXXXXXXXXXXXXXXXXXXXXXXXXXXXXXXXXXXXXXXXXXXXXXXXXXXXXXXXXXXXXXXXXXXXXXXXXXXXXXX
