__________________________________________________________________________________________
P________________________________________________________________________________________1
_____________111111111_________11111111_______1111111111__________________________________
__________________________________________________________________________________________
________________________________________________________________________11111111111_______
_____________________1111111111111111_____________________________________________________
___________________________________111111111______________________________________________
_________1111111111111111______________________11111111___________________________________
_____11111111111111_________________________________11111111_______________________111111_
______________1111111111111111____________________________________________________________
_____________111111111____________________________________1111111111111111________________
_______________11111111111________________________________________________________________
__________________________________________________________________________________________
________________________________________________________________________11111111____11111_
_____________________________________________________________111111111111111_111111111111_
________________________________________________________________1111111111111111__________
_________________________________________________________________________________11111111_
______11111111________________________111111111111________________________________________
XXXXXXXXXXXXXXXXXXXXXXXXXXXXXXXXXXXXXXXXXXXXXXXXXXXXXXXXXXXXXXXXXXXXXXXXXXXXXXXXXXXXXXXXXX
__________________________________________________________________________________________
