__________________________________________________________________________________________
P________________________________________________________________________________________1
__________11111111________________________________________________________111111111111111_
_______________________________________11111111111111___11111111111_______________________
______________________________1111111111111111____________________________________________
_____________________________________111111111111_________________________________________
__________________________________________________________________________________________
__________________1111111111111111_______________________________________________________W
_____________________________1111111111111111_____________________________________________
__________________________________________________________________________________________
__________________________________________________________________________________________
__________________________________________________________________________________1111111_
________________________________111111111111_____________________________________________W
__________11111111111_____111111111111_________________________111111111111_______________
________________________111111111111111_________________________111111111________________W
____________________________________11111111111___________________________________________
______________________________11111111___________________11111111111______________________
_________________111111111111_____________________________________________________________
__________________________________________________________________________________________
__________________________________________________________________________________________
__________________________________________________________________________________________
__________________________________________________________________________________________
XXXXXXXXXXXXXXXXXXXXXXXXXXXXXXXXXXXXXXXXXXXXXXXXXXXXXXXXXXXXXXXXXXXXXXXXXXXXXXXXXXXXXXXXXX
