__________________________________________________________________________________________
P________________________________________________________________________________________1
_______________________________________________________________1111111111111111__________W
__________________________________________________________________________________________
____________________________________________________________________________________11111W
_______________________________________________________________________________1111111111_
_____111111111111_________________________________________________________________________
________________111111111111________1111111111111__________________111111111______1111111_
_________________________________11111111______111111111111__________________________1111_
_________________1111111111111111______________________________111111111__________________
____________1111111111111_________________________________________________________________
__________________________________________________________________________________________
______________________________________________________________1111111111111_______________
_________________________________________________________________111111111111111__________
______________________________________________________________1111111111111111___________W
________________________11111111_____111111111______11111111111111_____1111111111111___11_
____________________________1111111111__1111111111111_____________________________________
_____________________________________________________________________________111111111111_
__________________________________________________________________________________________
__________________________________________________________________________________________
__________________________________________________________________________________________
__________________________________________________________________________________________
XXXXXXXXXXXXXXXXXXXXXXXXXXXXXXXXXXXXXXXXXXXXXXXXXXXXXXXXXXXXXXXXXXXXXXXXXXXXXXXXXXXXXXXXXX
