__________________________________________________________________________________________
P________________________________________________________________________________________1
__________________________________________________________________________________________
_________________________________1111111111111111_________________________________________
______________________________________________111111111111111_____111111111111111_________
_______________________11111111111111_____________________________________________________
____111111111111_______11111111111111_11111111111_______________________11111111111_______
__________________1111111111_____________11111111_________________________________________
_____________________________________________1111111111___________________________________
__________________________________________________________________________________________
___________________111111111111111_______11111111_____1111111111111_______________________
_____________________________11111111111111__________111111111________________________111_
____11111111111___________________________________________________________________________
____________________________________________11111111111___________________________________
_______________111111111111111__________________________________________________111111111_
_______________________11111111___111111111111_____________________1111111111_____________
_______________________111111111111_11111111____________________111111111111______________
__________________________________________________________________________________________
__________________________________________________________________________________________
__________________________________________________________________________________________
__________________________________________________________________________________________
__________________________________________________________________________________________
XXXXXXXXXXXXXXXXXXXXXXXXXXXXXXXXXXXXXXXXXXXXXXXXXXXXXXXXXXXXXXXXXXXXXXXXXXXXXXXXXXXXXXXXXX
