11111111111111111111111111111111111111111111111111111111111111111111111111111111111111111111
1__________________________________________________________________________________________1
1__________________________________________________________________________________________1
1__________________________________________________________________________________________1
1__________________________________________________________________________________________1
1__________________________________________________________________________________________1
1__________________________________________________________________________________________1
1__________________________________________________________________________________________1
1______________________________________________________________________________________P___1
1_________________________________________________________________W________________________1
11_____11111111111111111111111111____________________111111111111111111111111111111111111111
1__________________________________________________________________________________________1
1__________________________________________________________________________________________1
1__________________________________________________________________________________________1
1__________________________________________________________________________________________1
1__________________________________________________________________________________________1
1__________________________________________________________________________________________1
1__________________________________________________________________________________________1
1__________________________________________________________________________________________1
1__________________________________________________________________________________________1
1__________________________________________________________________________________________1
1__________________________________________________________________________________________1
1__________________________________________________________________________________________1
1__________________________________________________________________________________________1
1__________________________________________________________________________________________1
1__________________________________________________________________________________________1
1__________________________________________________________________________________________1
1__________________________________________________________________________________________1
1__________________________________________________________________________________________1
1__________________________________________________________________________________________1
1__________________________________________________________________________________________1
1XXXXXXXXXXXXXXXXXXXXXXXXXXXXXXXXXXXXXXXXXXXXXXXXXXXXXXXXXXXXXXXXXXXXXXXXXXXXXXXXXXXXXXXXXX1
