__________________________________________________________________________________________
P________________________________________________________________________________________1
____________________11111111111111_________________11111111111____________________________
_____________111111111______________________________________________________________11111_
_____11111111111111_______________________________111111111111____________________________
__________________________________________________________________________________________
_________________11111111111111_____111111111111111_____1111111111111__________________11_
_____________________________11111111_______________________________________________11111_
__________________________________________________________________________________________
________________________111111111_____________________________________________________111_
_________________________________________111111111__________1111111111____________________
____________________1111111111111________11111111111111___________________________________
_________________________________________111111111111_________111111111111________________
_________________1111111111111111____________________________11111111111__________________
___1111111111____________________________11111111111111________111111111111111____________
____________________________________________111111111111111_______________________________
__________111111111111111_________________________________________________________________
________________________________________1111111111___________11111111111__________________
__________________________________________________________________________________________
__________________________________________________________________________________________
__________________________________________________________________________________________
XXXXXXXXXXXXXXXXXXXXXXXXXXXXXXXXXXXXXXXXXXXXXXXXXXXXXXXXXXXXXXXXXXXXXXXXXXXXXXXXXXXXXXXXXX
