__________________________________________________________________________________________
P________________________________________________________________________________________1
______________________________________111111111___________________________________________
______________111111111111___111111111___111111111111111__1111111111111111________________
______111111111_______________________11111111111______________________________________11_
________________________________________________________________11111111111_______________
__________________________________________________________________________________________
_____________________________________________________________________________________1111_
__________________________________________1111111111_____111111111111___________________1_
__________________11111111____________1111111111111111________________11111111____________
_____________________________________________________111111111111111______________________
_____________________1111111111111111_____________________________________________________
____________________1111111111111111______________________________________________________
_______________________________________________________________11111111_____1111111111111_
__________________________________________________________________________________________
___________________________11111111_________________________________1111111111111_________
__________1111111111111111____1111111111__________________________________________________
_____________________1111111111________________1111111111_________________111111111111111_
__________________________________________________________________________________________
__________________________________________________________________________________________
__________________________________________________________________________________________
XXXXXXXXXXXXXXXXXXXXXXXXXXXXXXXXXXXXXXXXXXXXXXXXXXXXXXXXXXXXXXXXXXXXXXXXXXXXXXXXXXXXXXXXXX
