11111111111111111111111111111111111111111111111111111111111111111111111111111111111111111111
1_________________________________________________________________________________________W1
1_P________________________________________________________________________________________1
1__________________________________________________________________________________________1
1__________________________________________________________________________________1_______1
1_1111111111_______________________________________________________________________________1
1________________________________________________________________1_________________________1
1____________________________________________________________________1_____________________1
1_________________________________11_______________________________________________________1
1______________________1___________________________________________________________________1
1__________________________________________1________________________________________111111_1
1_________________________________________________________________________1________________1
1__________________________________________________________11______________________________1
1__________________________________________________________________________________________1
1_______________________________________________1__________________________________________1
1________________________________1_________________________________________11______________1
1__________________________________________________________________________________________1
1__________________________________________________________________________________________1
1__________________________________________________________________________________________1
1______________________________________________11__________________________________________1
1___________1111111111_____________________________________________________________________1
1__________________________________________________________________________________________1
1_________________________________11111111111__________________11__________________________1
1__________________________________________________________________________________________1
1________________________________________________________11________________________________1
1__________________________________________________________________________________________1
1__________________________________________________________________________________________1
1__________________________________________________________________________________________1
1XXXXXXXXXXXXXXXXXXXXXXXXXXXXXXXXXXXXXXXXXXXXXXXXXXXXXXXXXXXXXXXXXXXXXXXXXXXXXXXXXXXXXXXXXX1
